WWWWWWWWWWWWWW WWWWWWWWWWWWW
WS          WW W           W
W WWWW WWWW WW W WWWW WWWW W
W WWWW WWWW WW W WWWW WWWW W
W WWWW WWWW WW W WWWW WWWW W
W                          W
W WWWW WW WWWWWWWW WW WWWW W
W WWWW WW WWWWWWWW WW WWWW W
W      WW    WW    WW      W
WWWWWW WWWWW WW WWWWW WWWWWW
WWWWWW WWWWW WW WWWWW WWWWWW
WWWWWW WW          WW WWWWWW
WWWWWW WW WWW  WWW WW WWWWWW
WWWWWW WW W      W WW WWWWWW
       WW W      W WW       
WWWWWW WW W      W WW WWWWWW
WWWWWW WW WWWWWWWW WW WWWWWW
WWWWWW WW          WW WWWWWW
WWWWWW WWWWW WW WWWWW WWWWWW
WWWWWW WWWWW WW WWWWW WWWWWW
W      WW    WW    WW      W
W WWWW WW WWWWWWWW WW WWWW W
W WWWW WW WWWWWWWW WW WWWW W
W                          W
W WWWW WWWWW W W WWWW WWWW W
W WWWW WWWWW W W WWWW WWWW W
W WWWW WWWWW W W WWWW WWWW W
W            W W           W
WWWWWWWWWWWWWW WWWWWWWWWWWWW
